###############
#             #
#  A          #
#             #
#             #
#             #
#             #
#       B     #
#             #
###############
