###################################
#             #                   #
#  A          #                   #
#             #                   #
#             #     ###########   #
#             #     #    #    #   #
#             #     #  # # #  #   #
#             #     #B #   #  #   #
#             #     ########  #   #
#             #               #   #
#    ##########               #   #
#    #        #               #   #
#    #        #                   #
#    #        #                   #
### ## #### ############ ##########
#       #     #                   #
#       #     ##################  #
#       #     #                   #
#       #     #                   #
#       #     #  #                #
#       #     #  #                #
#       #     #  #                #
#       #     #  #                #
#       #     #  #                #
#       #        #                #
#       #        #                #
################ ##################
