###############
#             #
#  A          #
#             #
#             #
#    ##########
#    #     B  #
#    #        #
#             #
###############
